*......#############
....#...............
....#....@..........
....#...............
....#....#..*.......
.*..#....######.....
....#....*..........
....#....######.....
....#.........*.....
....................