*......#############
....................
....................
.........@..........
............*.......
....................
.........*..........