*......#############
....................
....................
....#....@..........
....#....#..*.......
....#....####.......
....#....*..........