*++++++#############
++++++++++++++++++++
++++++++++++++++++++
+++++++++@++++++++++
++++++++++++++++++++
++++++++++++++++++++
+++++++++*++++++++++